########################################
#...........#....................#.....#
#.##...#....#.........##.........#.....#
#....#.#.#......####.....#.......###...#
####.#...#.####.#........#.......#..#..#
.....#####.#....####.....#.......####...
.....#...#.####.#.....####.#..#.........
####.#...#....#.#..#..#..#.#..#.#####..#
#....#...#.#.##.####..####.####.#.#.#..#
#.###...........................#.#.#..#
#........#@....g.......................#
########################################