########################################
#...........#..........................#
#.##...#....#..#######.................#
#....#.#.#......#.......#......#..#....#
####.#...#.####.#.SPWN..#.####.#..#....#
.....#####.#..#...SPWN..#.#..#..##.....#
.......#...####.####.####.####.#..#....#
####...#.#.#..#.#..#.#..#.#....#..#....#
#......#.#.#..#.#..#.####.####.#..#....#
#.###..................................#
#........#@............................#
########################################