########################################
#O........@.#....................#....O#
#.##...#....#.........##.........#.....#
#....#.#.#......####.....#.......###...#
####.#...#.####.#........#.......#..#..#
.....#####.#....####.....#.......####...
.....#...#.####.#.....####.#..#.........
####.#...#....#.#..#..#..#.#..#.#####..#
#....#...#.#.##.####..####.####.#.#.#..#
#O###...........................#.#.#.O#
#........#....b.p.i.c..................#
########################################