########################################
#...........#..........................#
#.##...#....#..#######.................#
#....#.#.#..............#......#..#....#
####.#...#.####.........#.####.#..#....#
.....#####.#..#.........#.#..#..##......
.......#...####.####.####.####.#..#.....
####...#.#.#..#.#..#.#..#.#....#..#....#
#......#.#.#..#.#..#.####.####.#..#....#
#.###..................................#
#........#@............................#
########################################